111111111111111111111
100000000000000000001
100002200000002000001
100010000000000000001
100000000000022000001
100000000000000000001
111111111111111111111